唉声叹气	哀声叹气
安装机器	按装机器
意义深奥	意义深粤
邦交	帮交
锐不可当	锐不可挡
纵横捭阖	纵横稗阖 纵横俾阖 纵横捭合
以见一斑	以见一般
班门弄斧	搬门弄斧 般门弄斧
民生凋敝	民生凋蔽 民生凋弊
遮天蔽日	遮天避日
大有裨益	大有稗益 大有捭益 大有啤益
完璧归赵	完壁归赵
刚愎自用	刚腹自用
脉搏微弱	脉膊微弱 脉博微弱
赤膊上阵	赤搏上阵 赤博上阵
部署已定	布署已定
惨无人道	残无人道
残酷无情	惨酷无情
酒中掺水	酒中渗水
清澈见底	清彻见底 清撤见底
撤销处分	撒销处分
驰骋疆场	驰聘疆场
鞭笞三百	鞭苔三百
签字盖戳	签字盖戮
惨遭杀戮	惨遭杀戳
义不容辞	义不容词
拼拼凑凑	拼拼凑揍
出类拔萃	出类拔粹
尽瘁国事	尽悴国事
以逸待劳	以逸代劳
制订公约	制定公约
稍事耽搁	稍事担搁
管理档案	管理挡案
玷污清白	沾污清白
掉以轻心	调以轻心 吊以轻心
横渡长江	横度长江
欢度春节	欢渡春节
堕落腐化	坠落腐化
咄咄逼人	咄拙逼人 拙拙逼人 绌绌逼人
翻天覆地	翻天复地
三番两次	三翻两次
反复无常	翻复无常
妨碍交通	防碍交通
防卫工作	妨卫工作
枉费心机	枉废心机 妄费心机
认识肤浅	认识浮浅
英雄气概	英雄气慨
慷慨解囊	慷概解囊
贡献巨大	供献巨大
辜负好意	姑负好意
明知故犯	明知固犯
步入正轨	步入正规
诡计多端	鬼计多端
随声附和	随身附和 随声附合 随生附和
宽宏大量	宽洪大量 宽弘大量
全国轰动	全国哄动
哄堂大笑	轰堂大笑
声音洪亮	声音宏亮
荒谬绝伦	谎谬绝伦
心灰意冷	心恢意冷
掉入陷阱	掉入陷井
即使如此	既使如此
既然如此	即然如此
毕竟	必竞 必竟
丰功伟绩	丰功伟迹
模范事迹	模范事绩
不计其数	不计其记 不记其数
艰难困苦	坚难困苦
情不自禁	情不自尽
绝对服从	决对服从
颗粒归仓	棵粒归仓
刻苦耐劳	克苦耐劳
克服困难	刻服困难
腊梅盛开	蜡梅盛开
味同嚼蜡	味同嚼腊
陈词滥调	陈词烂调
狂轰滥炸	狂轰烂炸
篮球运动	蓝球运动
描绘蓝图	描绘篮图
再接再厉	再接再励
励精图治	历精图治 厉精图治
劳动锻炼	劳动锻练
军事训练	军事训炼
锤炼语言	锤练语言
语言简练	语言简炼
书写潦草	书写了草
风靡一时	风糜一时
甜言密语	甜言蜜语
自寻烦恼	自寻烦脑
打架斗殴	打架斗欧
风尘仆仆	风尘扑扑 风尘仆扑
启封试卷	起封试卷
感情融洽	感情融恰
恰如其分	洽如其分
乔装打扮	巧妆打扮 巧装打扮 乔妆打扮
一窍不通	一巧不通 一窃不通
孺子可教	儒子可教
含辛茹苦	含辛如苦
喜上眉梢	喜上眉稍 喜上眉捎
挑拨是非	挑拨事非
莫衷一是	莫衷一事 莫中一是
毛骨悚然	毛骨竦然 毛骨耸然
鬼鬼祟祟	鬼鬼祟崇 鬼鬼崇崇
雪中送炭	雪中送碳
提纲挈领	题纲挈领 提纲携领
金榜题名	金榜提名
泄露秘密	泻露秘密
通宵达旦	通霄达旦
九霄云外	九宵云外
考生须知	考生需知
需要文件	须要文件
世外桃源	世外桃园
圆满成功	园满成功
异口同声	一口同声
性格急躁	性格急燥
口干舌燥	口干舌躁
绿草如茵	绿草如荫
记忆犹新	记忆尤新
怨天尤人	怨天由人 怨天犹人 怨天忧人
尤其重要	犹其重要
振聋发聩	震聋发聩 振聋发溃
震耳欲聋	振耳欲聋
出奇制胜	出其制胜 出奇致胜
以致失败	以至失败
有所遵循	有所尊循
由衷感谢	由忠感谢
坐落东方	座落东方
黯然失色	暗然矢色 暗然失色
按部就班	按步就班
白璧无瑕	白璧无暇 白壁无瑕
目不暇接	目不瑕接 目不遐接
再来一次	在来一次
在会议上	再会议上
书籍满架	书藉满架
别出心裁	别出心才 别出新裁
病入膏肓	病人膏盲 病入膏盲
不假思索	不加思索
川流不息	穿流不息
奋发图强	愤发图强
蜂拥而来	蜂涌而来
面面俱到	面面具到
釜底抽薪	斧底抽薪
富丽堂皇	富丽唐皇 富丽堂黄
张弛合度	张驰合度
天涯海角	天崖海角
汗流浃背	汗流夹背
好高骛远	好高鹜远
大声喝彩	大声喝采
焕然一新	涣然一新
业已	业以
痴心妄想	痴心忘想 痴心枉想
金碧辉煌	金壁辉煌
精神涣散	精神焕散
不可思议	不可思异 不可思义
流芳百世	留芳百世
留连忘返	留恋忘返
漫山遍野	满山遍野
面黄肌瘦	面黄饥瘦
明辨是非	明辫是非 明辩是非
名副其实	名符其实 名付其实
名列前茅	名列前矛
模糊不清	摸糊不清
漠不关心	莫不关心
恼羞成怒	脑羞成怒
迫不及待	迫不急待
急不可待	及不可待
休养生息	修养生息
早自修	早自休
喧宾夺主	宣宾夺主
一筹莫展	一愁莫展
略胜一筹	略胜一愁
直截了当	直接了当
走投无路	走途无路 走头无路
出人头地	出人投地
夜幕降临	夜暮降临
暮色苍茫	蓦色苍茫
真知灼见	真知卓见 真知勺见
和蔼可亲	和霭可亲
称心如意	趁心如意
墨守成规	默守成规 默守陈规 墨守陈规
一张一弛	一张一驰
相形见绌	相形见拙
黯然神伤	暗然神伤
戳穿阴谋	戮穿阴谋
飞扬跋扈	飞扬跋户 飞扬拔扈
鞠躬尽瘁	鞠躬尽萃 鞠躬尽粹
披星戴月	披星带月
进制殚精竭虑	进制掸精竭虑
稗官野史	裨官野史 卑宫野史
投机倒把	投机捣把
这倒不错	这到不错
中流砥柱	中流抵柱 中流坻柱
自暴自弃	自抱自弃 自曝自弃 自爆自弃
英雄辈出	英雄倍出
并行不悖	并行不背 并行不脖
辩证法	辨证法
翻云覆雨	翻云复雨 反云覆雨
浪费金钱	浪废金钱
破釜沉舟	破斧沉舟
原子辐射	原子副射
布置完毕	部置完毕
令人恐怖	令人恐布
扬长而去	扬常而去
天崩地坼	天崩地拆
入不敷出	入不付出
感人腑肺	感人腑府
言简意赅	言简意骇 言简意该
卑躬屈膝	卑恭屈膝 卑躬曲膝
灌输知识	贯输知识
羽扇纶巾	羽扇伦巾
发扬光大	发扬广大
性格粗犷	性格粗旷
行踪诡秘	行踪鬼秘
阴谋诡计	阴谋鬼计
貌合神离	貌和神离
和盘托出	合盘托出
曲高和寡	曲高合寡
万事亨通	万事享通
侯门如海	候门如海
惨绝人寰	惨绝人圜 惨绝人环
张皇失措	张慌失措 张惶失措
心灰意懒	心恢意懒
言谈诙谐	言谈恢谐
风雨如晦	风雨如诲
浑身是胆	混身是胆
杯盘狼藉	杯盘狼籍
嘉宾满座	佳宾满座
缄口不言	箴口不言 咸口不言
草菅人命	草管人命 草官人命
事过境迁	事过景迁
装裱	装表
兢兢业业	兢竞业业 精精业业
不胫而走	不径而走 不颈而走 不经而走
针灸疗法	针炙疗法
赳赳武夫	赳纠武夫
前倨后恭	前踞后恭
龙盘虎踞	龙盘虎据
相距不远	相距不矩
规规矩矩	规规矩距
狙击敌人	阻击敌人
千钧一发	千钓一发
工程竣工	工程峻工
热炕头	热坑头
不卑不亢	不卑不吭 不卑不抗
坑害好人	吭害好人
空前绝后	恐前绝后
脍炙人口	脍灸人口 烩炙人口
功亏一篑	功亏一匮 功亏一蒉 功亏一溃
心狠手辣	心狠手棘
无耻谰言	无耻滥言
可做蓝本	可做篮本
篮球健将	蓝球健将
书声琅琅	书声朗朗
身体羸弱	身体嬴弱 身体赢弱
大多雷同	大多类同
利害得失	厉害得失
变本加厉	变本加利
厉行节约	励行节约 力行节约
火中取栗	火中取粟
一枕黄粱	一枕黄梁
寥寥无几	廖寥无几 了了无几
浏览一遍	流览一遍
手榴弹	手溜弹
惨遭屠戮	惨遭屠戳
戮力同心	戳力同心
高官厚禄	高官厚录
庸庸碌碌	庸庸碌录 庸庸录录
语无伦次	语无论次 语无仑次 语无轮次
脉络分明	脉胳分明
无理谩骂	无理漫骂 无礼漫骂
望风披靡	望风披糜
观摩教学	观磨教学
碑帖临摹	碑帖临摩
呕心沥血	呕心历血 沤心沥血
金瓯无缺	金殴无缺 金欧无缺
无独有偶	无独有隅
坚如磐石	坚如磬石 坚如盘石
如法炮制	如法泡制 如法炮炮
蓬荜生辉	篷荜生辉 蓬壁生辉 篷筚生辉
披沙拣金	批沙拣金
嗜酒成癖	嗜酒成僻
纰漏百出	批漏百出
艰苦朴素	艰苦扑素
前仆后继	前扑后继
星罗棋布	星罗旗布 星罗棋旗
修葺一新	修茸一新
顷刻之间	倾刻之间
罄竹难书	磬竹难书 磐竹难书
为国捐躯	为国捐驱
怙恶不悛	沽恶不悛 怙恶不俊
入场券	入场卷
尚待商榷	尚待商确
却之不恭	缺之不恭
当仁不让	当人不让
人参鹿茸	人参鹿葺
矫揉造作	矫柔造作 矫糅造作 娇揉造作
耳濡目染	耳儒目染 耳语目染
歃血为盟	插血为盟
赡养父母	瞻养父母
礼尚往来	礼上往来
稍纵即逝	少纵即逝
首屈一指	手屈一指
授予奖章	受予奖章
军事部署	军事部暑 军事布署
不辨菽麦	不辨黍麦
肆无忌惮	肄无忌惮 肆无忌殚 肆无忌弹
辰巳午未	辰己午未
到处传诵	到处传颂
走一趟	走一堂
趟水过河	淌水过河
列出提纲	列出题纲
恬不知耻	腆不知耻 括不知耻 刮不知耻
铤而走险	挺而走险
如火如荼	如火如茶
深为惋惜	深为婉惜
甘冒不韪	甘冒不讳
从中斡旋	从中干旋
运筹帷幄	运筹惟幄 运筹帷握
戊戌政变	戍戌政变
定期会晤	定期会悟
雨声淅沥	雨声浙沥
月明星稀	月明星希
条分缕析	条分缕拆
全家迁徙	全家迁徒
瑕瑜互见	暇瑜互见
自顾不暇	自顾不瑕
声闻遐迩	声闻暇迩
向往光明	想往光明
骁勇善战	饶勇善战
通宵不眠	通霄不眠
直上重霄	直上重宵
歪风邪气	歪风斜气
不屑一顾	不宵一顾
睡眼惺忪	睡醒惺忪 睡眼醒忪
学识修养	学识休养
气喘吁吁	气喘嘘嘘
申酉戌亥	申酉戍亥
一切就绪	一切就序
栩栩如生	诩诩如生 栩诩如生
徇私舞弊	殉私舞弊 徇私舞敝 循私舞弊
循序渐进	循序惭进 循序前进 寻序渐进 循绪渐进
揠苗助长	偃苗助长
偃旗息鼓	堰旗息鼓 揠旗息鼓
举行宴会	举行晏会
湮没不闻	淹没不闻
此系赝品	此系膺品
敷衍塞责	敷演塞责
杳无音信	沓无音信
专程谒见	专程竭见
打躬作揖	打躬作辑
演绎归纳	演译归纳
苦心孤诣	苦心孤意 苦心孤旨 若心孤旨
一劳永逸	一劳永易
贻笑大方	遗笑大方
大学肄业	大学肆业
绿树成荫	绿树成茵 绿树成阴
一望无垠	一望无银
化学反应	化学反映
反映意见	反应意见
式样新颖	式样新疑
优柔寡断	犹柔寡断 忧柔寡断
良莠不齐	良秀不齐
手头宽裕	手头宽余
滥竽充数	烂芋充数 滥芋充数 滥于充数 烂竽充数 乱竽充数
向隅而泣	向偶而泣
始终不渝	始终不遇
逾期作废	渝期作废
元气大伤	原气大伤
断壁颓垣	断壁颓恒
缘木求鱼	沿木求鱼
销赃灭迹	销脏灭迹
心浮气躁	心浮气燥
鼓噪而进	鼓躁而进
读书札记	读书扎记
不眨眼	不贬眼
敲诈勒索	敲榨勒索
压榨平民	压诈平民
改弦更张	改弦更章
通货膨胀	通货膨涨
动辄得咎	动则得咎 动辙得咎 动辄得咨
计划缜密	计划慎密
举世震惊	举振震惊
仗义执言	仗义直言
掷地有声	掷地有抛
满脸皱纹	满脸绉纹
招摇撞骗	招谣撞骗 招摇装骗
梳妆打扮	梳装打扮
惴惴不安	惴揣不安 揣揣不安
缀句成篇	掇句成篇
呱呱坠地	呱呱堕地
心劳日拙	心劳日绌
恣意胡为	姿意胡为
胡作姿态	胡作恣态
恶意诅咒	恶意咀咒
编纂字典	编篡字典
虎视眈眈	虎视眈耽 虎视耽耽
安装	按装
甘拜下风	甘败下风
针砭	针贬
舶来品	泊来品
脉搏	脉博 脉膊
松弛	松驰 松池
精粹	精萃
重叠	重迭
度假村	渡假村
妨碍	防碍
辐射	幅射
一副对联	一幅对联
天翻地覆	天翻地复
气概	气慨
一鼓作气	一鼓足气 一股作气
悬梁刺股	悬梁刺骨
粗犷	粗旷
食不果腹	食不裹腹
震撼	振撼 振憾 震憾
凑合	凑和
候车室	侯车室
即使	既使
一如既往	一如继往 一如即往
挖墙脚	挖墙角
一诺千金	一偌千金 一诺千斤 一喏千金
竣工	峻工
不落窠臼	不落巢臼 不落窝臼
打蜡	打腊
死皮赖脸	死皮癞脸
蓝天白云	兰天白云
鼎力相助	鼎立相助 顶力相助
老两口	老俩口
黄粱美梦	黄梁美梦
瞭望	了望
水龙头	水笼头
杀戮	杀戳
痉挛	痉孪
美轮美奂	美仑美奂 美伦美奂 美轮美涣
啰唆	罗唆
蛛丝马迹	蛛丝蚂迹 珠丝马迹
萎靡不振	萎糜不振
沉湎	沉面 沉缅 沉腼
明信片	名信片
大拇指	大姆指
平添	凭添
出其不意	出奇不意
修葺	修茸
青睐	青徕 亲睐 青眯
声名鹊起	声名雀起
发轫	发韧
瘙痒病	搔痒病
欣赏	欣尝
谈笑风生	谈笑风声
人情世故	人情事故
有恃无恐	有持无恐
额手称庆	额首称庆
追溯	追朔
趋之若鹜	趋之若骛
迁徙	迁徒
洁白无瑕	洁白无暇
九霄	九宵
宣泄	渲泄
寒暄	寒渲 寒喧
旋律	炫律 弦律
赝品	厌品 膺品
不能自已	不能自己
犹如猛虎	尤如猛虎
竭泽而渔	竭泽而鱼
赃款	脏款
蘸水	醮水
蛰伏	蜇伏
装帧	装祯
饮鸩止渴	饮鸠止渴
坐镇	坐阵
旁征博引	旁证博引 旁证侧引
炙手可热	灸手可热
九州	九洲
床笫之私	床第之私
恣意妄为	姿意妄为
编纂	编篡
坐月子	做月子
慷慨	慷概 康慨
枯燥	枯躁
立竿见影	立竿见映 立杆见影
立下宏愿	立下弘愿
流光溢彩	流光异彩
贸然行事	冒然行事
明察暗访	明查暗访
怦然心动	砰然心动
歉收	欠收
切磋	切搓 切蹉
惹是生非	惹事生非
融会贯通	融汇贯通
山清水秀	山青水秀
神祇	神祗
声呐	声讷 声纳
时过境迁	时过景迁 事过景迁
售罄	售磬
水泄不通	水泻不通
水蒸气	水蒸汽
挑三拣四	挑三捡四
妥帖	妥贴
委曲求全	委屈求全
无所顾忌	无所顾及
毋庸置疑	勿庸置疑
陷阱	陷井 陷汫
消弭	消弥
笑眯眯	笑咪咪
严峻	严竣 严俊 严骏
一笔勾销	一笔勾消 一笔钩销
一刹那	一霎那
源远流长	渊远流长
黏合剂	粘合剂
针砭时弊	针贬时弊 针贬时敝
蒸馏水	蒸溜水
支支吾吾	支支唔唔
坐落	座落
蹚浑水	趟浑水
叱咤风云	叱诧风云
嗤之以鼻	斥之以鼻
怄气	呕气
慵懒	庸懒
阈值	阀值
璀璨	璀灿
羁绊	羁判 羁拌
貂蝉	貂婵
嬉笑怒骂	戏笑怒骂 嘻笑怒骂
停泊	停舶
雾凇	雾淞 雾松
安详	安祥
绊脚石	拌脚石
鞭笞	鞭苔
憋气	蹩气
兵荒马乱	兵慌马乱
病原体	病源体
博弈	搏弈
不省人事	不醒人事
部署	布署 部暑
恻隐之心	侧隐之心 测隐之心
掺和	掺合
长年累月	常年累月
充耳不闻	冲耳不闻
冲账	充账
蹿红	窜红 串红
淬炼	淬练 萃炼
大材小用	大才小用
大声疾呼	大声急呼
跌宕起伏	跌荡起伏
独辟蹊径	独辟溪径 独劈蹊径
渡过难关	度过难关
对簿公堂	对薄公堂
翻两番	翻两翻
烦躁	烦燥 烦澡
蜂拥而至	蜂涌而至
俯首帖耳	俯首贴耳
戛然而止	嘎然而止
古今杂糅	古今杂揉
哈密瓜	哈蜜瓜
河汊	河岔
鸿篇巨制	宏篇巨制
缉拿	辑拿
既往不咎	继往不究 继往不咎 既往不究
叫苦不迭	叫苦不叠
秸秆	秸杆
金刚钻	金钢钻
精疲力竭	筋疲力竭
狙击手	阻击手
巨擘	巨擎
诀窍	决窍
啰嗦	罗嗦 罗唆
滥觞	烂觞
犹如猛虎下山	尤如猛虎下山
关怀备至	关怀倍至
略见一斑	略见一般 略见一班
宽宏大度	宽洪大量
伶牙俐齿	伶牙利齿
名列前茅	名列前矛
挑拔是非	挑拔事非
待价而沽	待价而估
积毁销骨	积毁消骨
行踪诡密	行踪鬼密
精兵简政	精兵减政
蛊惑人心	盅惑人心 鼓惑人心
眼花缭乱	眼花潦乱 眼花瞭乱 眼花撩乱
销声匿迹	消声匿迹
不醒人事	不省人事
震撼人心	振撼人心 震憾人心
插科打诨	插科打浑
截然不同	绝然不同
要言不烦	要言不繁
层峦叠嶂	层峦迭嶂 层峦叠障
明火执仗	明火执杖 明火直仗
弥天大罪	迷天大罪
火势蔓延	火势漫延
饱经沧桑	饱经苍桑
无精打采	无精打彩
噤若寒蝉	禁若寒蝉
喋喋不休	碟碟不休 谍谍不休
虚无缥缈	虚无缥渺 虚无飘渺 虚无飘缈
计日程功	计日成功
牟取暴利	谋取暴利
相辅相承	相辅相成
好景不长	好景不常
请予接洽	请予接恰
政权颠覆	政权颠复
提心吊胆	提心掉胆 题心吊胆
无礼谩骂	无礼漫骂
很有裨益	很有俾益
按价赔偿	按价赔尝
玷污名誉	沾污名誉
图书装帧	图书装祯
战胜朝廷	战胜朝庭
水乳交融	水乳交溶
应接不暇	应接不遐
违法肇事	违法造事
冒天下之大不韪	冒天下之大不违
分道扬镳	分道扬标 分到扬镳 分道扬镖
殚精竭虑	殚精竭虚 单精竭虑 惮精竭虑
嘻皮笑脸	喜皮笑脸
远大抱负	远大报负
佩戴首饰	佩戴手饰
私下磋商	私下蹉商
璀璨夺目	璀烂夺目 璀灿夺目
德艺双馨	德艺双磬
心头烦躁	心头烦燥
万里平畴	万里平筹
高潮迭起	高潮叠起
群英荟萃	群英汇萃
湮没无闻	淹没无闻
千锤百炼	千锤百练
欢欣鼓舞	欢心鼓舞
常备不懈	长备不懈
引咎辞职	引疚辞职
不容置疑	不容质疑
百战不殆	百战不贻 百战不怠
举止安详	举止安祥
束之高阁	束之高搁
摩肩接踵	摸肩接踵 磨肩接踵
果断抉择	果断决择
茅屋修葺	茅屋修茸
良辰美景	良晨美景
赋予使命	赋与使命
偷盗销脏	偷盗消脏
濒临破产	频临破产
触目惊心	怵目惊心
若即若离	若既若离 若及若离
与日俱增	与日具增
绵里藏针	棉里藏针
骁勇无敌	晓勇无敌
不徇私情	不循私情
剑拔弩张	剑拔驽张
匪夷所思	匪贻所思 非夷所思
为虎作伥	为虎作账 为虎作昌 为虎作怅
渔翁得利	鱼翁得利
一抔黄土	一杯黄土
擢发难数	捉发难数
勤能补拙	勤能补绌
扑朔迷离	朴朔迷离 扑塑迷离
笑容可掬	笑容可鞠 笑容可局
置若罔闻	置若惘闻 置若往闻
面面相觑	面面相去 面面相觊
浑浑噩噩	浑浑恶恶
繁文褥节	烦文褥节
风声鹤唳	风声鹤泪 风声鹤戾 风生鹤唳
流言蜚语	流言飞语 流言诽语 流言非语
勘误校正	堪误校正
圆舞曲	园舞曲
巧夺天工	巧夺天功
寻物启事	寻物启示
壁立千仞	壁立千刃
涣然冰释	焕然冰释
成绩斐然	成绩蜚然
名门望族	名门旺族
标新立异	标新立意
一语破的	一语破敌
严惩不贷	严惩不怠 严惩不待
买椟还珠	买牍还珠 买犊还珠
相反相成	相反相承
粗制滥造	粗制烂造
心心相印	心心相映 心心相应
同仇敌忾	同仇敌慨
最后通牒	最后通谍
蔓延	曼延 漫延
途经	途径
必需品	必须品
赓续	庚续
血脉偾张	血脉喷张 血脉贲张
情结	情节
行拘	刑拘
蓝天	兰天
度假	渡假
犹如	尤如
饮鸠止渴	饮鸠止渴
奋楫笃行	奋辑笃行
擘画	擎画
返岗	反岗
铆足干劲	卯足干劲
抚慰	妩慰 扶慰
凌乱	另乱
未来	末来
徇私枉法	循私枉法
斑斓	斑澜 斑烂 班斓
端详	端祥
朝廷	朝庭
揣摩	瑞摩 湍摩 惴摩 揣摹
催眠	摧眠
噩耗	恶耗 噩蚝
噩梦	恶梦
发愣	发楞
雕像	雕象
防范	防犯
粉碎	粉粹
分量	份量
幅员	辐员
赋予	付予
股份	股分
害臊	害躁
涵养	函养
耗费	耗废
和蔼	和霭
河槽	河漕
诙谐	恢协 恢谐
诨号	浑号
矫健	骄健
骄纵	娇纵
骄矜	娇矜
缉私	辑私
嫁接	稼接
间谍	间牒
精彩	精采
诅咒	嘴咒 咀咒
抉择	决择
勘误	堪误
林荫	林阴
浏览	流览
笼络	拢络
录像	录象
梦魇	梦靥 梦餍
缅怀	湎怀
描摹	瞄摹 描摩 描模
殴打	欧打
讴歌	呕歌
起讫	起迄
贻害	遗害
引申	引伸
荫庇	阴庇
荫凉	阴凉
鱼竿	鱼杆
渔船	鱼船
蛰居	蜇居
帐篷	账篷 帐蓬
真谛	真缔
振奋	震奋
震慑	振慑 震摄
账号	帐号
肢解	支解
桎梏	桎锢
钟磬	钟罄
通牒	通碟 通谍
通缉	通辑
晤面	悟面
相片	像片
泄露	泻露
亵渎	邪渎 亵读 亵赎
沿用	延用
装扮	妆扮
商榷	商摧 商确
漱口	嗽口 涑口
厮杀	撕杀
诉讼	诉诵
融洽	融恰
省份	省分
清澈	清撤 清沏
洽谈	恰谈 洽淡
辨析	辩析 辫析
九重霄	九重宵
订书机	钉书机
戊戌年	戊戍年
行李包	行旅包
荧光屏	萤光屏
座山雕	座山碉
报仇雪恨	报仇血恨
安邦定国	安帮定国
安分守己	安份守己 安分守已 安份守已
百废待兴	百费待兴
白浪滔天	白浪淘天
报销发票	报消发票
背道而驰	倍道而驰 背道而弛
碧波粼粼	碧波鳞鳞
筚路蓝缕	筚路篮缕
敝帚自珍	蔽帚自珍 敞帚自珍
鞭辟入里	鞭僻入里 鞭辟入理
变幻莫测	变换莫测
不翼而飞	不冀而飞
沧海桑田	苍海桑田
察言观色	察颜观色
瞠目结舌	瞋目结舌
成群结队	成群接队
崇山峻岭	重山峻岭
重蹈覆辙	重倒覆辙 重蹈复辙
唇枪舌剑	唇枪舌箭
寸草春晖	寸草春辉
打抱不平	打报不平
戴罪立功	带罪立功
淡泊明志	淡薄名志
殚思竭虑	惮思竭虑
党同伐异	党同罚异
缔结和约	谛结和约
豆蔻年华	豆寇年华
独抒己见	独书己见
恶贯满盈	恶惯满盈 恶灌满盈
尔虞我诈	尔欲我诈 尔愚我诈
幡然悔悟	翻然悔误
反躬自省	反恭自省
反应灵活	反映灵活
蜚声遐迩	飞声遐迩
蜂拥而上	蜂涌而上
凤毛麟角	凤毛鳞角
覆水难收	复水难收
负隅顽抗	负偶顽抗
高中肄业	高中肆业
各行其是	各行其事
攻城略地	攻城掠地
骨鲠在喉	骨梗在喉
故弄玄虚	故弄弦虚 故弄悬虚
神工鬼斧	神功鬼斧
鬼蜮伎俩	鬼蜮技俩
海市蜃楼	海市胜楼 海市唇楼
亘古未有	恒古未有
侯门似海	候门似海
虎踞龙盘	虎居龙盘 虎据龙盘
怀瑾握瑜	怀瑾握玉
荒诞不经	慌诞不经
浑然一体	混然一体
混为一谈	混为一团
饥肠辘辘	饥肠漉漉
激活经济	击活经济
急流勇退	激流勇退
见异思迁	见义思迁
截长补短	接长补短
揭竿而起	揭杆而起
锦绣河山	锦秀河山
晋升工资	进升工资
晶莹剔透	晶莹惕透
津津有味	精精有味 津津有昧 斤斤有味
迥然不同	炯然不同
鸠占鹊巢	鸩占鹊巢 鸠占雀巢
久负盛名	久负胜名
开仓赈饥	开仓振饥
开门揖盗	开门缉盗
开宗明义	开宗明意 开中明义
恪守不渝	克守不渝
夸夸其谈	夸夸奇谈
窥豹一斑	窥豹一般
滥调文章	烂调文章
老生常谈	老生长谈 老声常谈
厉兵秣马	利兵秣马 历兵秣马 励兵秣马
临风陨泪	临风殒泪
林林总总	嶙嶙总总 林林种种 零零总总
流连忘返	流莲忘返 留恋忘返 留连忘返
孪生姐妹	挛生姐妹
门可罗雀	门可落雀
弥天大谎	迷天大谎
秘而不宣	密而不宣
勉为其难	免为其难
名震一时	名振一时
能伸能屈	能伸能曲
浓妆淡抹	浓装淡抹
赔礼道歉	陪礼道歉
气势汹汹	气势凶凶
平心而论	凭心而论
迄今为止	讫今为止
轻歌曼舞	轻歌慢舞 轻歌漫舞
曲突徙薪	曲突徒薪 曲突徙新
雀小脏全	鹊小脏全
人才荟萃	人才汇萃
人心惟危	人心唯危
如雷贯耳	如雷灌耳
色厉内荏	色厉内任
舍生取义	舍身取义
伸张正义	申张正义
升官晋爵	升官进爵
生杀予夺	生杀与夺
声势赫奕	声势赫弈
始作俑者	始作踊者 始作佣者
势不可当	势不可挡
事情棘手	事情辣手
手不释卷	手不失卷 手不释劵
冰融雪化	冰溶雪化
死不瞑目	死不冥目 死不暝目
死心塌地	死心踏地 死心蹋地
驷马难追	四马难追
碎琼乱玉	粹琼乱玉
韬光养晦	韬光养侮 滔光养晦
贪赃枉法	贪脏枉法
天方夜谭	天方夜谈
天网恢恢	天网灰灰
舐犊情深	舔犊情深
头童齿豁	头痛齿豁
头晕目眩	头晕目炫
荼毒生灵	茶毒生灵 涂毒生灵
乌走鸟飞	兔走鸟飞
脱颖而出	脱颍而出
微言大义	微言大议 微言大意
岿然不动	巍然不动
惟妙惟肖	维妙维俏 唯妙唯肖 唯妙唯俏
违犯刑法	违反刑法
文过饰非	闻过饰非 文过是非
稳操胜券	稳操胜卷
乌烟瘴气	乌烟嶂气 乌烟脏气
无上光荣	无尚光荣
熙熙攘攘	熙煕嚷嚷
闲情逸致	闲情逸志
相辅相成	相辅相承
嚣张跋扈	嚣张拔扈
胁从不问	协从不问
心惊胆战	心惊胆颤
虚度年华	虚渡年华
循声望去	寻声望去
一副中药	一幅中药
一副尊容	一幅尊容
一副眼镜	一付眼镜
一塌糊涂	一蹋糊涂
依然故我	依然固我
绮丽多彩	漪丽多彩
以儆效尤	以警效尤 以儆效优
以身殉职	以身徇职
异曲同工	异曲同功
义愤填膺	义愤填鹰 义愤填赝
意兴盎然	意兴昂然
因材施教	因才施教
芸芸众生	纭纭众生
原驰蜡象	原驰腊象
招徕顾客	招来顾客
仗义疏财	仗义输财
知书达理	知书达礼
至理名言	致理名言 至理明言
珠联璧合	珠连璧合 珠联壁合
追根溯源	追根索源
装腔作势	装腔做势
锱铢必较	淄铢必较 锱株必较 锱珠必较
自鸣得意	自命得意 自名得意
自圆其说	自园其说
众口铄金	众口烁金
责无旁贷	责无旁代
欲盖弥彰	欲盖弥漳 欲盖弥张
营私舞弊	营私舞敝
杳无音讯	沓无音信
图穷匕见	图穷匕现
蜕化变质	退化变质
形销骨立	形消骨立
遐思迩想	暇思迩想
叹为观止	叹为观只 叹为观之
披肝沥胆	披肝历胆
奴颜婢膝	奴颜卑膝
弄巧成拙	弄巧成绌
缠绵悱恻	缠绵悱测
肝脑涂地	肝脑途地
感人肺腑	感人肺腹 感人肺府
膏粱子弟	膏梁子弟
海角天涯	海角天崖
发聋振聩	发聋震聩
激流勇退	急流勇退
离经叛道	离经判道
燎原烈火	缭原烈火
龙蟠虎踞	龙盘虎据
碌碌无为	录录无为 绿绿无为
落英缤纷	落英宾纷
惩前毖后	惩前毙后 惩前必后
美玉无瑕	美玉无暇
铭记不忘	名记不忘
目不交睫	目不交捷
凤冠霞帔	凤冠霞披 凤冠霞佩
震人心魄	振人心魄
不瘟不火	不温不火
坐享其成	坐想其成
巾帼英雄	巾国英雄
日新月异	日新月益
背井离乡	背景离乡
如虹气势	如洪气势
空空如也	空空如野
淋漓尽致	淋漓尽至
弹丸之地	蛋丸之地
无可非议	无可非异
孑然一身	洁然一身
直言不讳	直言不晦 执言不讳 直言不诲 直言不悔
锋芒毕露	锋芒必露 峰芒毕露
顾名思义	故名思义
适得其反	事得其反
劳逸结合	劳役结合
占了上风	占了上峰
包罗万象	包罗万项 包罗万像
轻而易举	轻而一举
不可名状	不可名壮 不可明状
道貌岸然	道貌暗然 道貌安然
浮想联翩	浮想联篇 浮想连翩
物极必反	物及必反 物极必返
无可置疑	无可质疑
岌岌可危	及及可危
人才辈出	人才倍出
养尊处优	养尊处悠
受益匪浅	受益非浅
不求甚解	不求慎解 不求深解
自力更生	自立更生
不可救药	不可救要 不可就药
忧心忡忡	忧心冲冲 忧心重重 忧心憧憧
孩提时代	孩啼时代
蒸蒸日上	争争日上
至关重要	致关重要
功不可没	功不可抹
应变能力	应辨能力
姗姗来迟	跚跚来迟 珊珊来迟
仁至义尽	人至义尽
意气用事	义气用事
余勇可贾	余勇可沽 余勇可估
永葆青年	永保青年
举棋不定	举旗不定
无则加勉	无则加免
贸然行动	冒然行动
当务之急	当物之急
莘莘学子	辛辛学子
比比皆是	彼彼皆是
百孔千疮	百孔千窗
韦编三绝	苇编三绝
一本万利	一本万历
势均力敌	势均利敌 势匀力敌
冥思苦想	瞑思苦想 名思苦想
权宜之计	全宜之计
一蹶不振	一獗不振
大器晚成	大气晚成
大名鼎鼎	大名顶顶
立案侦查	立案侦察
沟通南北	勾通南北
纷至沓耒	纷至踏耒
倚老卖老	依老卖老 以老卖老
口蜜腹剑	口密腹箭
不即不离	不及不离 不接不离 不既不离
一泻千里	一泄千里
杞人忧天	齐人忧天 岂人忧天
坐地分赃	坐地分脏
装潢门面	装黄门面
乌合之众	污合之众 乌和之众
疾风知劲草	急风知劲草
爱戴	爱带
白皙	白晰
暴乱	爆乱
报酬	报筹
爆炸	暴炸
卑怯	卑却
才华	财华 材华
喝彩	喝采
遨游	翱游
娘俩	娘两
更迭	更跌 更叠
洽商	恰商
玷辱	沾辱
仲裁	中裁
雕砌	雕彻
辟谣	劈谣
名片	明片
藐视	渺视 缈视
暮然	募然
募捐	蓦捐
杂沓	杂踏
弈棋	奕棋
疏浚	疏峻
吉祥	吉详 吉羊
肖像	肖象
开销	开消
伫立	贮立 纻立
皱纹	绉纹
燥热	躁热
肿胀	肿涨
羁縻	羁靡
翱翔	遨翔
渲染	宣染
延伸	延申
奢靡	赊靡 奢糜
毗邻	辟邻 毗临
彪悍	骠悍
永诀	永决
拥戴	拥带
煤炭	煤碳
编撰	编篡
按摩	按磨
暴躁	爆躁 暴燥
显像管	显象管
暴发户	爆发户
肇事者	造事者
坐标系	座标系
照相机	照像机
暖烘烘	暖哄哄
座右铭	坐右铭
名信片	明信片
天然气	天然汽
煤气机	煤汽机
引申义	引伸义
雄赳赳	雄纠纠
冷不防	冷不妨
佼佼者	皎皎者
财务科	财物科
文邹邹	文诌诌
副食品	付食品
百炼成钢	百练成钢
火山爆发	火山暴发
爱不释手	爱不失手
安居乐业	按居乐业
黯然泪下	暗然泪下
暗无天日	黯无天日
嗷嗷待哺	敖敖待哺
决不罢休	绝不罢休
白璧微瑕	白壁微瑕
半途而废	半途而费
山洪暴发	山洪爆发
武装暴动	武装爆动
五色斑斓	五色斑澜
百步穿杨	百步串杨
百尺竿头	百尺杆头
罢黜百家	罢绌百家
原物璧还	原物必还
森严壁垒	森严壁磊
能言善辩	能言善辨
膘肥体壮	骠肥体壮
彪炳千古	标柄千古
彬彬有礼	斌斌有礼 彬彬有理 杉杉有理
屏气凝神	摒气凝神
拨乱反正	拨乱返正
人所不齿	人所不耻
不共戴天	不共带天
不寒而栗	不寒而粟 不寒而立
不遑顾及	不惶顾及
不刊之论	不堪之论
不名一文	不明一文
宁死不屈	宁死不曲
麻木不仁	麻木不忍
不祥之兆	不详之兆 不详之照
步履维艰	步履维坚
雄才大略	雄材大略
才疏学浅	材疏学浅 才疏学贱
神采奕奕	神采弈弈
才华横溢	才华横益 材华横溢
兴高采烈	兴高采列 兴高彩烈
张灯结彩	张灯结采
粲然一笑	灿然一笑
苍茫大海	沧茫大海
藏垢纳污	藏诟纳污
层出不穷	成出不穷
层见叠出	层见迭出
蝉联冠军	蝉连冠军
陈陈相因	陈陈相应
自学成材	自学成才
惩一儆百	惩一禁百
吃里扒外	吃里爬外
首当其冲	首当其中 首当其充
山峦重叠	山峦重迭
重振旗鼓	重整旗鼓
除旧布新	除旧补新
处心积虑	处心集虑
传诵一时	传颂一时
吹毛求疵	吹毛求刺 吹毛求呲
从长计议	从常计议
粗枝大叶	粗枝大意
厝火积薪	措火积薪
措手不及	错手不及
大放厥词	大放獗词
大庭广众	大廷广众
倒打一耙	倒打一把
得不偿失	得不赏失 得不尝失
得陇望蜀	得垄望蜀
地大物博	地大物搏
草木凋零	草木雕零
掂斤播两	掂斤拨两
雕虫小技	凋虫小技
调虎离山	吊虎离山
动则得辄	动则得咎
叠床架屋	迭床架屋
以毒攻毒	以毒功毒
独当一面	独挡一面
独占鳌头	独占骜头 独占螯头
嫉贤妒能	疾贤妒能
断章取义	断章取意
杜绝浪费	堵绝浪费
对症下药	对针下药
两军对峙	两军对恃
发号施令	发号司令
令人发指	令人发直
繁文缛节	繁文溽节 烦文缛节
易如反掌	易如翻掌
防范未然	防患未燃
蜚声文坛	飞声文坛
纲纪废弛	纲纪废驰
废寝忘食	费寝忘食
费尽心思	废尽心思
分庭抗礼	分庭抗理
纷至沓来	纷至踏来
焚膏继晷	焚膏既晷
愤懑不平	愤闷不平
奋笔疾书	愤笔疾书
幅员辽阔	幅圆辽阔
浮光掠影	浮光略影
改邪归正	改斜归正
甘之如饴	甘之如怡
感恩戴德	感恩带德
根深蒂固	根深底固 根深地固
工力悉敌	工力悉抵
全神贯注	全神灌注
鬼斧神工	鬼釜神工 鬼斧神功
过犹不及	过尤不及 过忧不及
和衷共济	合衷共济
后发制人	后发治人
画地为牢	划地为牢
回光返照	回光反照
昏聩无能	昏馈无能
独具慧眼	独具惠眼
浑玉璞金	浑玉朴金
豁然开朗	忽然开朗
祸国殃民	祸国秧民
激浊扬清	击浊扬清
疾言厉色	急言厉色
集腋成裘	集液成裘 集掖成裘
济济一堂	挤挤一堂
继往开来	既往开来
嘉言懿行	佳言懿行
坚壁清野	艰壁清野
坚不可摧	艰不可摧
历尽艰辛	历尽坚辛
可资借鉴	可资借戒
弱不禁风	弱不经风
金刚怒目	金刚努目
金刚钻头	金钢钻头
绝无仅有	决无仅有
跻身三强	挤身三强
精诚所至	精诚所致
居心叵测	居心不测
鸠形鹄面	鸩形鹄面
举一反三	举一返三
拒谏饰非	拒谏是非
一应俱全	一应具全
赞不绝口	赞不决口
竣工验收	峻工验收
开诚布公	开诚不公
开天辟地	开天劈地
开源节流	开源截流
戡平叛乱	勘平叛乱
刻画人物	刻划人物
科头跣足	科头洗足
克己奉公	刻己奉公
克勤克俭	刻勤刻俭
困兽犹斗	困兽尤斗
意兴阑珊	意兴阑姗
宁缺毋滥	宁缺毋烂
老成持重	老陈持重
老奸巨猾	老奸巨滑
雷厉风行	雷历风行
其乐陶陶	其乐淘淘
理屈词穷	理曲词穷
立功赎罪	立功渎罪
厉行节俭	励行节约
历历在目	厉厉在目
藕断丝连	偶断丝连 藕断丝联
连锁反应	连锁反映
寥若晨星	寥若辰星 廖若晨星
横征暴敛	横征暴殓
浏览报纸	流览报纸
老态龙钟	老态龙肿
崭露头角	暂露头角
炉火纯青	炉火成青
膂力过人	旅力过人
沦肌浃髓	沦肌夹髓
无与伦比	无与论比
论功行赏	轮功行赏
慢条斯理	漫条斯理
漫不经心	慢不经心
茫无头绪	茫无头序
贸然从事	冒然从事
门里出身	门里出生
门庭若市	门廷若市
懵懂无知	朦懂无知
糜烂不堪	靡烂不堪
靡日不思	糜日不思
靡靡之音	糜糜之音
天下靡然	天下糜然
祖传秘方	祖传密方
沉湎往事	沉缅往事
缅怀先烈	湎怀先烈
深明大义	深明大意
薄暮瞑瞑	薄暮冥冥
明哲保身	名哲保身
摩肩擦背	磨肩擦背
摩崖石刻	磨崖石刻
顶礼膜拜	顶礼模拜 顶礼莫拜
莫名其妙	莫明其妙
穷途末路	穷途没路
没齿难忘	末齿不忘
暮霭沉沉	暮蔼沉沉
令人目眩	令人目炫
水力发电	水利发电
各司其职	各施其职
铄石流金	烁石流金
司空见惯	司空见怪
耸人听闻	悚人听闻
追本溯源	追本朔源
素昧平生	素昧平身
昙花一现	昙花一显
袒胸露臂	坦胸露臂
长吁短叹	长嘘短叹
桃李满园	桃梨满园
誊写文章	誉写文章
醍醐灌顶	醍醐贯顶
天经地义	天经地仪
天理难容	天礼难容
亭亭玉立	婷婷玉立
通情达理	通情达礼
同等学力	同等学历
痛心疾首	疾心痛首 痛心嫉首
偷工减料	偷工简料
头头是道	投投是道
图谋不轨	图谋不规
生灵涂炭	生灵涂碳
推诚相见	推陈相见
推崇备至	推崇倍至
推脱责任	推托责任
推心置腹	推心至腹 推心知腹
囤积居奇	屯积居奇
歪门邪道	歪门斜道
玩世不恭	玩世不公
万古长青	万古常青
万贯家财	万冠家财
万籁俱寂	万籁具寂
忘恩负义	忘恩负意
忘乎所以	忘夫所以
望而却步	望而怯步
望洋兴叹	望洋心叹
正襟危坐	正襟威坐 正襟围坐
精神矍铄	精神矍烁 精神矍砾
危言耸听	危言悚听
危如累卵	危如磊卵
为富不仁	为富不人 为富不忍
委曲婉转	委屈婉转
尾大不掉	尾大不吊
文恬武嬉	文恬武嘻
有条不紊	有条不稳
无人问津	无人问斤
左右开弓	左右开工
做贼心虚	作贼心虚
坐以待毙	坐以待毖
座无虚席	坐无虚席
暴戾恣睢	暴烈恣睢
自食其力	自食其利
自命不凡	自命不繁 自鸣不凡 自名不凡
纵横阖合	纵横捭合
足智多谋	卓智多谋
飞机着陆	飞机着落
谆谆告诫	谆谆告戒
抓耳挠腮	抓耳扰腮
钟灵毓秀	钟灵玉秀
奋斗终生	奋斗终身
终身大事	终生大事
仲裁委员	仲栽委员
寡不敌众	寡不抵众
不负众望	不浮众望
口诛笔伐	口株笔伐
赈济灾民	振济灾民
指手画脚	指手划脚
郑重其事	珍重其事 郑重其实
执迷不悟	执迷不吾 执谜不悟
标本兼治	表本兼治
治丝益棼	治丝益纷
志大才疏	志大材疏
专心致志	专心至志
秩序井然	轶序井然
振振有词	震震有词
振奋人心	震奋人心
振笔疾书	振笔急书
远见卓识	远见灼识
真相大白	真象大白
浅尝辄止	浅尝则止
作奸犯科	作奸犯课
重重叠叠	重重迭迭
照本宣科	照本宣课
昭然若揭	照然若揭
招惹是非	招惹事非
彰善瘅恶	彰善惮恶
战战兢兢	战战惊惊
斩钉截铁	斩钉载铁 斩钉接铁
沾沾自喜	玷玷自喜
沾亲带故	玷亲带故 拈亲带故
令人咋舌	令人乍舌
不骄不躁	不骄不燥
栽赃陷害	栽脏陷害
殒身不恤	陨身不恤 损身不恤
越俎代庖	越俎待庖 越俎代包
园林园丁	圆林圆丁
园地园艺	圆地圆艺
坐收渔利	坐收鱼利 座收渔利
囿于成见	宥于成见
沽名钓誉	估名钓誉 姑名钓誉
有口皆碑	有口皆杯
耳根清净	耳根清静
利害攸关	利害悠关
踊跃报名	涌跃报名
勇往直前	永往直前
永葆青春	永保青春
一拥而入	一涌而入
壅塞不通	拥塞不通
雍容华贵	壅荣华贵
隐隐约约	影影约约
影影绰绰	隐隐绰绰
引咎自责	引疚自责
因地制宜	因地治宜
学习肄业	学习肆业
义无反顾	义无返顾
义正词严	意正词严
意气风发	义气风发
不郎不秀	不郎不莠
词不达意	词不达义
因噎废食	因壹废食 因噎费食
倚仗权势	依仗权势
贻害无穷	遗害无穷
怡然自得	贻然自得
以一当十	以一挡十
毫无疑义	毫无疑议
移花接木	移花截木
不遗余力	不遣余力 不贻余力 不一余力
一视同仁	一视同人
一脉相承	一脉相成
一概而论	一盖而论
一蹴而就	一促而就
一成不变	一层不变
吊销执照	吊消执照
弃甲曳兵	弃甲拽兵
耀武扬威	跃武扬威
趾高气扬	指高气扬 志高气扬
洋洋洒洒	扬扬洒洒
手疾眼快	手急眼快
演绎推理	演译推理
沿袭成规	延袭成规
严正声明	严正申明
严阵以待	严阵以代 严正以待
言不由衷	言不由中
和颜悦色	和彦悦色 和言悦色
恹恹欲睡	厌厌欲睡
徇情枉法	殉情枉法
以身殉国	以身徇国
泱泱大国	怏怏大国 央央大国
不足为训	不作为训
气度不凡	器度不凡
轩然大波	喧然大波
千头万绪	千投万绪 千头万序
自我吹嘘	自我吹吁
大相径庭	大相胫庭 大相径廷
嘘寒问暖	吁寒问暖 虚寒问暖
沆瀣一气	沆泄一气
心安理得	心安礼得 心安里得
心旷神怡	心旷神饴
惺惺作态	猩猩作态
凶相毕露	凶相必露
热胀冷缩	热涨冷缩
直抒胸臆	直抒胸意
秀外慧中	秀外惠中
扶老携幼	扶老偕幼 扶老携幻
白头偕老	白头携老
不拘小节	不拘小结 不驹小节
风雨潇潇	风雨萧萧
逍遥法外	消遥法外
宵衣旰食	宵衣肝食 宵衣干食
响彻云霄	响彻云宵
降龙伏虎	降龙服虎
安之若素	安置若素
先礼后兵	先理后兵
先发制人	先发治人
下车伊始	下车一始
遐迩闻名	瑕迩闻名
丢人现眼	丢人显眼
现身说法	显身说法
细枝末节	细枝末结
喜出望外	喜出往外
畏葸不前	畏崽不前
作息时间	作歇时间
息事宁人	歇事宁人
除恶务尽	除恶勿尽
五体投地	五体头地
五彩斑斓	五彩斑烂 五彩班斓
无懈可击	无泄可击
无隙可乘	无细可乘
无所适从	无所是从
无所不至	无所不致
无事生非	无是生非
无坚不摧	无艰不摧
无济于事	无计于事
无稽之谈	无嵇之谈 无机之谈 无讥之谈 无计之谈
株连无辜	诛连无辜
无耻之尤	无耻之犹
翻来覆去	反来复去
瓮中捉鳖	翁中捉鳖
瓮声瓮气	翁声翁气
涨红了脸	胀红了脸
坂上走丸	板上走丸
莫可名状	莫可明状
循规蹈矩	循规导矩
三番五次	三翻五次
评头论足	评头评足
史无前例	史无前列 世无前例
煞费苦心	煞废苦心 杀费苦心
大伤元气	大伤原气
丰富多彩	丰富多采
众目睽睽	众目暌暌 众目癸癸
洗耳恭听	洗耳躬听
人心向背	人心项背
万象更新	万相更新
毋庸讳言	毋用讳言
支吾其词	支无其词
切磋琢磨	切搓琢磨
无妄之灾	无忘之灾
不言而喻	不言而渝 不言而语
不吝赐教	不另赐教
尽心竭力	尽心极力
言之凿凿	言之足足
投鼠忌器	投鼠计器
形影相吊	形影相掉
含蓄蕴藉	含蓄蕴籍
安装电话	按装电话
如期竣工	如期峻工
以偏概全	以偏盖全
九州方圆	九洲方圆
黯然销魂	暗然销魂
磕磕绊绊	磕磕拌拌
官运亨通	官运享通
临摹书法	临摩书法
掎角之势	奇角之势
按兵不动	安兵不动
挑肥拣瘦	挑肥捡瘦
肺腑之言	肺腹之言
如鲠在喉	如梗在喉
愤世嫉俗	愤世疾俗
明珠暗投	名珠暗投
苦思冥想	苦思瞑想
各抒己见	各书己见 各抒已见
按图索骥	按途索骥
暴殄天物	暴珍天物 暴舔天物
寻章摘句	循章摘句
桀骜不驯	桀鳌不驯 桀傲不驯
万马齐喑	万马齐暗
以身作则	以身作责
衷心感谢	中心感谢
一见钟情	一见衷情
摇摇欲坠	摇摇欲堕
虚左以待	虚座以待
原形毕露	原形必露
蓄意报复	蓄意抱复
以德报怨	以德抱怨
投桃报李	投桃抱李
抱怨不堪	报怨不堪
深受蒙蔽	深受蒙敝
备受欢迎	倍受欢迎
艰苦备尝	艰苦倍尝
神采飞扬	神彩飞扬
风采动人	风彩动人
保护国粹	保护国萃
连篇累牍	连篇累椟
穷兵黩武	穷兵渎武
老实本分	老实本份
分内之事	份內之事 份内之事
返工重来	反工重来
认罪伏法	认罪服法
拾金不昧	拾金不味
广有羽翼	广有羽冀
斐然成章	蜚然成章 菲然成章
明察秋毫	明察秋豪
爱慕虚荣	爱幕虚荣
微不足道	微不足到
垂头丧气	垂头伤气
取义成仁	取义成人
神妙莫测	神妙漠测
奄奄一息	淹淹一息
万贯家私	万惯家私
拂袖而去	佛袖而去
峨冠博带	峨冠搏带
熟能生巧	孰能生巧
怪涎不经	怪涎不径
欣欣向荣	新新向荣
扬扬自得	杨杨自得
依稀可见	依希可见
血气方刚	血气放刚
纵横决荡	纵横绝荡
大显身手	大献身手
精雕细琢	精雕细啄
挥汗如雨	挥汉如雨
得意忘形	得意忘行
漠然置之	莫然置之
生死攸关	生死悠关
呼朋引伴	呼朋引半
爱屋及乌	爱屋及巫 爱乌及屋 爱乌及巫
网开一面	妄开一面
方兴未艾	方兴未爱
梦寐以求	梦昧以求
万劫不复	万阶不复
囊中羞涩	馕中羞涩
闪烁其辞	闪烁其词
风驰电掣	风弛电掣 风驰电擎
肃然起敬	萧然起敬
恍然大悟	晃然大悟
合纵连横	合从连横
冰清玉洁	冰青玉洁
休戚与共	休威与共
心猿意马	心袁意马
鸦雀无声	鸦鹊无声
铁杵磨针	铁柱磨针
络绎不绝	络驿不绝 落绎不绝
波涛汹涌	波涛凶涌
重峦叠嶂	重峦叠樟
绰绰有余	卓卓有余
达官贵人	大官贵人
大雨滂沱	大雨磅礴 大雨磅砣
睹物思人	堵物思人
度日如年	渡日如年
纷纷扬扬	纷纷杨杨
想入非非	想入菲菲
人迹罕至	人迹罕致
置之度外	置之渡外
温故知新	湿故知新
蹉跎岁月	蹉驼岁月
措不及防	瘁不及防
忐忑不安	忑忐不安
无缘无故	无原无故
阿谀奉承	阿臾奉承
忍俊不禁	忍骏不禁
囫囵吞枣	囫囵舌枣
人声鼎沸	人声鼎拂
朗朗上口	琅琅上口 郎郎上口
声泪俱下	声泪具下
感慨良深	感概良深
妄下断语	忘下断语
屈尊纡贵	曲尊纡贵
大失所望	大失所忘
无动于衷	无动于中 无动于衰
诲人不倦	悔人不倦
手足无措	手足无错
判若两人	叛若两人
穷困潦倒	穷困缭倒 穷困撩倒
惊慌失措	惊皇失措 惊荒失措
张牙舞爪	张芽舞爪
声名狼籍	声鸣狼籍
绝路逢生	绝路蓬生
不知所措	不知所错
任劳任怨	任劳任恕
辨伪去妄	辩伪去忘
巧妙绝伦	巧妙绝轮
妄自菲薄	忘自菲薄
不攻自破	不功自破
百废俱兴	百费俱兴
自吹自擂	自吹自雷
妄自尊大	忘自尊大 枉自尊大
相提并论	相题并论
脍灸人口	哙灸人口
锲而不舍	契而不舍
雷霆万钧	雷霆万钩
桀骜不逊	桀鹜不逊
层峦迭嶂	层峦迭障
游目骋怀	游目聘怀
见风使舵	见风驶舵
蜂拥而入	蜂涌而入
驾轻就熟	架轻就熟
进退维谷	进退唯谷
鳞次栉比	麟次栉比 璘次栉比 鳞次节比 磷次栉比
米珠薪桂	米珠薪贵
毁家纾难	毁家抒难
安步当车	安部当车
并驾齐驱	并驾齐躯
大是大非	大事大非
退避三舍	退辟三舍
饿殍遍野	饿浮遍野
琳琅满目	琳郎满目 琳朗满目
婀娜多姿	阿那多姿
蓬头垢面	蓬头诟面
追名逐利	追名遂利
怡神悦目	贻神悦目
贫贱不移	贫践不移
狼狈不堪	狼狈不勘
怏怏不快	泱泱不快
耳闻目睹	耳闻目赌
杳无消息	查无消息
一意孤行	一意弧行
怀才不遇	怀材不遇
扣人心扉	扣人心肺
扶摇直上	扶遥直上
冉冉不绝	再再不绝
滔滔不绝	涛涛不绝
屡见不鲜	缕见不鲜
引喻失义	引谕失意
坦荡如砥	坦荡如坻
形影不离	行影不离
离弦之箭	离玄之箭
投机取巧	头机取巧
虚张声势	虚张生势
声色俱厉	声色具历
姹紫嫣红	姹紫艳红 诧紫嫣红
小心翼翼	小心冀冀
扣人心弦	扣人心玄
劳而无功	劳而无工
不屑置辩	不屑置辨
今非昔比	今非昔此
仗势欺人	仗事欺人
深居简出	深居俭出
终南捷径	终南捷境
苟全性命	荀全性命
觥筹交错	觥筹交措
妙手偶得	妙手隅得
旁逸斜出	旁逸邪出
错综复杂	锗踪复杂
老当益壮	老当益状
挑拨离间	挑拔离间
招是搬非	招事搬非
绝不雷同	决不雷同
就地取材	就地取才
椎心泣血	锥心泣血
炯炯有神	迥迥有神
济寒赈贫	济寒振贫
失魂落魄	失魄落魂
披荆斩棘	披荆崭棘
长篇累牍	长篇累椟
满目疮痍	满目创痍
冠冕堂皇	官冕堂皇 冠冕堂黄
残羹冷炙	残羹冷灸
勃然大怒	脖然大怒
故步自封	故不自封
固若金汤	故若金汤
故伎重演	故技重演
推陈出新	推阵出新
明眸善睐	明牟善睐
一言不合	一言不和
不知所终	不知所踪
张弛有度	张驰有度
耳熟能详	耳熟能祥
萍水相逢	苹水相逢
幡然醒悟	翻然醒悟
独树一帜	独树一指 独竖一帜
目不识丁	目不识钉
斤斤计较	津津计较
津津乐道	斤斤乐道
浑身解数	浑身懈数
心无旁骛	心无旁鹜
侃侃而谈	砍砍而谈
无可厚非	无可后非
酩酊大醉	酩顶大醉
相濡以沫	相儒以沫
未雨绸缪	未雨绸谬
胸有成竹	匈有成竹
心血来潮	心血来朝
心慈手软	心兹手软
心花怒放	心花努放
先入为主	先人为主
惺惺相惜	惺惺相昔
浮云蔽日	浮云敝日
披星带月	披星戴月
张冠李戴	张冠李带
可见一斑	可见一班
同甘共苦	同干共苦
高枕无忧	高枕无优
孤陋寡闻	孤漏寡闻
高深莫测	高深莫侧
寿终正寝	寿终正顷
随波逐流	隋波逐流
长途跋涉	长途拔涉
摧枯拉朽	摧枯拉巧
东施效颦	东施效频
对酒当歌	对洒当歌
画龙点睛	画龙点晴
登峰造极	登锋造极 登峰造及
返璞归真	反璞归真
逢场作戏	逢场做戏
厚积薄发	厚积簿发
精忠报国	精衷报国
惊涛骇浪	惊滔骇浪 惊涛害浪
嫉恶如仇	疾恶如仇
含情脉脉	含情默默
大言不惭	大言不渐
不肖子孙	不屑子孙
弹冠相庆	弹管相庆
含英咀华	含英咀花
积重难返	积重难反
祸起萧墙	祸起硝墙
放浪形骸	放浪形骇
心仪已久	心益已久
捉襟见肘	捉禁见肘
乐此不疲	乐此不皮
高屋建瓴	高屋建领
风华正茂	风华正貌
冰释前嫌	冰释前贤
面授机宜	面授机益
耳提面命	耳题面命
尽态极妍	尽态极艳
怒不可遏	怒不可扼
恃才放旷	适才放旷
期期艾艾	期期哀哀
道听途说	道听涂说
非同凡响	非同繁响
万恶不赦	万恶不射
恪尽职守	克尽职守
天衣无缝	天衣无逢
自出心裁	自出新裁
相得益彰	相得益张
悲欢离合	悲欢离和
屈指可数	曲指可数
臵若罔闻	臵若往闻
壮志难酬	壮志难筹
变化无常	变化无长
多愁善感	多仇善感
绝处逢生	绝处缝生
突如其来	突如奇来
泾渭分明	径渭分明 经伟分明
矢志不渝	矢志不逾
一帆风顺	一番风顺
如出一辙	如出一则
一刀两断	一刀两段
急功近利	急攻近利
功篑一匮	功亏一匮
虎视眈耽	虎视耽耽
终生事业	终身事业
公之于众	公诸于众
复原无瑕	复原无暇
体制机制	体质机制
进行激辩	进行激辨
深刻吸取	深刻听取
互联互通	互连互通
截至目前	截止目前
未辨真假	未辩真假
岐澳古道	歧澳古道
一手好字	一首好字
做好表率	作好表率
横扫对手	横少对手
提出议案	提出一案
拍照留念	拍照留恋
真抓实干	真扎实干
有所改变	有所改编
观光农业	光观农业
部门之间	部门只见
技术骨干	技术贵干
筚路蓝褛	筚路褴褛
蜿蜒曲折	宛然曲折
妙趣横生	妙脆横生
未解之谜	未解之迷
亲生父母	亲身父母
黄埔军校	黄浦军校
不苟言笑	不拘言笑
即便如此	既便如此
河清海晏	海清河晏
不依不饶	不依不挠
知识分子	知识份子
拴心留人	栓心留人
卷帙浩繁	卷轶浩繁
实至名归	名至实归
嗷敖待哺	敖敖待哺
既往不究	继往不究
防患未然	防患未燃
付诸东流	付之东流
浑浑噩恶	浑浑恶恶
克勤刻俭	刻勤刻俭
其乐陶淘	其乐淘淘
将功赎罪	将功渎罪
历厉在目	厉厉在目
一鳞半爪	一麟半爪
勠力同心	戳力同心
薄暮暝冥	薄暮冥冥
没齿不忘	末齿不忘
头投是道	投投是道
推托生病	推脱生病
受到威胁	收到威胁
早在去年	早再去年
不孚众望	不浮众望
振震有词	震震有词
重重叠迭	重重迭迭
芸纭众生	纭纭众生
园林圆丁	圆林圆丁
园地圆艺	圆地圆艺
雍荣华贵	壅荣华贵
临危受命	临急受命
毫无义议	毫无疑议
逸劳永易	一劳永易
歌舞升平	歌舞生平
藏污纳垢	藏污纳诟
气急败坏	气极败坏
千古一恸	千古一痛
前车之鉴	前车之戒
深致歉意	深致欠意
窥视	睽视
匮乏	馈乏 篑乏 溃乏
恣意	姿意
亲昵	亲呢
崇高	祟高
惩罚	尝罚
苔藓	台藓
贷款	袋款 帒款
莅临	位临
驱赶	袪赶
锦盒	錦盒
处置	处治
梳理	疏理
肄业	肆业 意业
鲤鱼	俚鱼 理鱼
辍学	缀学 掇学
疫情	役情
蹊跷	蹊翘 溪跷 奚跷
戊戌	戊戍
委屈	委曲
遗憾	遗撼
奋发	愤发
分歧	分岐
诬告	污告
醍醐	提醐
通讯员	通迅员
传闻	传文
凝聚	疑聚
旱灾	早灾
国籍	国藉
余悸	余季
花哨	花俏 花销
客栈	客站
户口簿	户口薄
讯号	迅号
油然	由然
导致	导至
震惊	振惊
荒芜	荒无
公顷	公倾
篮球	蓝球
斟酌	针酌
登录	登陆
针灸	针炙
擅自	善自
砝码	法码
莞尔	完尔
幌子	愰子 晃子
蜡烛	腊烛
笨拙	笨绌
总决赛	总结赛
猥亵	偎亵
缩水	宿水
炮制	泡制 跑制
对弈	对奕
情愫	情素
蓦然	募然
优惠券	优惠卷
博物	薄物
歧视	岐视
滑稽	滑嵇
棘手	蓟手
链接	连接
通宵	通霄
人才	人材
抨击	砰击 评击
挑拨	挑拔
公证处	公正处
选拔	选拨
残忍	惨忍
竞争	竟争
账目	帐目
呆愣	呆楞
制高点	置高点
纯净	纯静
怂恿	纵恿
视察	视查
娇宠	骄宠
仓促	伧促
嘚瑟	得瑟
逊色	孙色
体育界	体育届
濒临	频临
灵犀	灵息
旌旗	经旗
气溶胶	气融胶 气榕胶 气容胶 气熔胶 汽溶胶
厉害	历害
窠臼	窠旧
商务舱	商务仓
讲义气	讲意气
多米诺	多米喏
飘洒	漂洒
青年人	轻年人
笑靥	笑恹
健康	建康
对峙	对恃
绿洲	绿州
自诩	自翊 自栩
护堤	护提
淹没	湮没 俺没 掩没
沉默	沉墨
了解	瞭解
伎俩	技俩
光辉	光晖
免疫	兔疫
冗长	戎长
灿烂	璨烂
一炷香	一柱香
载体	裁体
缘分	篆分 喙分 缘份
活性炭	活性碳
内讧	内哄
节俭	节检
搀扶	掺扶
沟通	勾通
横梁	横樑
抱怨	报怨
船舷	船弦 船玄
禅意	婵意
驰骋	驰聘
别扭	憋扭
忏悔	忏侮
敞亮	敝亮
船舶	船泊
范畴	范筹
大概	大慨 大既
晦气	悔气
绊倒	拌倒
通讯	通迅
癖好	辟好
憧憬	幢憬 瞳憬 忡憬 童憬
诋毁	抵毁
掣肘	制肘 掣纣
晨昏	晨婚
厄运	恶运 噩运
天涯	天崖
坍塌	坍蹋
恶劣	恶列
和弦	和玄 和炫
蹙额	處额
概念	既念 慨念
粗略	粗咯
方圆	方园
豢养	蒙养 誊养
葱茏	葱笼 怱茏
容貌	容冒
草根	草跟
破例	破列
采拮	采洁
水浒传	水许传
蹒跚	蹒删
猝然	啐然
池鱼	池宇
凋敝	凋弊 凋蔽
挖掘	挖堀
参差	叄差 椮差
仇恨	仇狠
崛起	倔起
阊阖	阊盍
草垛	草䒳
愤懑	愤闷 愤满
斐然	裴然 霏然
陪伴	培伴
词缀	词叕
闲暇	闲瑕
秤砣	秤沱
帷幕	帷暮
疮疤	疮巴
斗篷	斗蓬
伺候	侍候 伺侯
迟钝	迟顿
扑朔	仆朔
漕运	曹运
花蕊	花芯
呈报	呈抱
深邃	深遂
鞭挞	鞭踏 鞭鞑
名垂青史	名倕青史
辞藻	辞澡
忤逆	许逆
覆盖	复盖
砗磲	阵磲
楷书	揩书
陶瓷	淘瓷
遴选	鳞选
蟾宫	蟾工
昌蒲	昌浦
赌气	堵气
坟墓	坟莹
储藏	诸藏
来源	来原
幽僻	幽辟
愁怨	蝵怨
羸弱	赢弱
抱歉	报歉 抱欠
桑葚	桑甚
槽枥	槽砺
模型	模形
刻薄	刻簿
勾销	勾消
筹划	踌划
凌冽	凌烈
箪竹	单竹
疟疾	虐疾
宏达	宏大
菁英	青英
抵御	抵卸
含蓄	含畜
聆听	吟听
弘扬	宏扬
半晌	半响
多情种	多情中
洗涤	洗条
矜持	今持
孤独	狐独
多样化	多佯化
腐朽	腐巧
大喊大叫	大咸大叫
大汗淋漓	大汗淋离
糊涂	糊塗 湖涂
盼望	昐望
单枪匹马	单抢匹马
点缀	点啜
荒淫	荒婬
涤纶	条纶
栋梁	冻梁
惦记	掂记
恒心	桓心
亘古	恒古
罕见	悍见
惠存	慧存
恭候	恭侯
谱写	普写
堤岸	提岸
凝固	疑固
裹挟	裹夹
毒手	霉手
公共	公供
内忧外患	内尤外患
敦实	墩实
孤鹜	孤骛 孤鸟
捣腾	岛腾
沧桑	仓桑 苍桑
黄澄澄	黄橙橙
解剖	解咅
排斥	排斤
地表水	地裱水
驾驭	驾驶 驾奴 驾驱 驾驮 驾权
恬静	甜静
邂逅	解逅 邂后
低碳	底碳
抵牾	抵唔
污垢	污诟 污后
好逑	好求
奉命	俸命
蚍蜉	蚍浮
当然	当燃
焕然	换然
复辟	复壁 复僻
杜宇	杜与
下功夫	下工夫
剔除	踢除
东滚西爬	东滚西扒
睥睨	脾睨
顿悟	盹悟
眷属	劵属
蹲守	尊守
蜉蝣	蜉游
狡猾	狡滑
崩溃	蹦溃
稀疏	稀梳
叮嘱	叮属
胴体	洞体
顶天立地	顶夫立地
琐屑	锁屑
披靡	披糜
眷顾	劵顾
缆绳	揽绳
当世无双	单世无双
发酵	发教
甄选	侦选
断语	继语
何尝	何常
开垦	开恳
烹饪	烹任
忌讳	忌晦 记讳
单薄	单簿
晦涩	悔涩
断崖式	断崖试
和煦	和洵 和熙 和照
唤醒	换醒
得意	得澺
皓羽	灏羽
非难	菲难
锻造	段造
风雅	凤雅
眩目	炫目
为人所不齿	为人所不耻
看得上眼	看的上眼
中肯	中垦
泛滥	泛烂
谜底	迷底
观摩	观摹
申请	伸请
萧条	肖条
炫耀	旋耀 眩耀
悬崖	悬涯 悬垭
尤其	犹其
等候	等侯
孪生	挛生
塑造	朔造
洗澡	洗燥 洗躁
鼓励	鼓厉
历史	厉史
瑕疵	暇疵
肮脏	肮赃
炙热	灸热
金华火腿	金华火煺
租赁	租贷 租凭
共享	共亨
河涌	河俑
贯穿	惯穿
环境	坏境
开幕	开慕
围绕	围饶
欢快	欢块
纷纷	分分
弹奏	谈奏
作为	做为
利益	俐益
改正	该正
优点	尤点
枯萎	枯委
凉快	凉块
措施	错施
飘扬	飘杨
漫天	瞒天
防疫	防役
应聘	应娉
抢夺	枪夺
星辰	星宸
番禺	蕃禺
淳朴	淳扑 纯朴 醇朴
紊乱	絮乱 稳乱 纹乱
灰烬	灰尽 烣烬
剽悍	骠悍
籍贯	藉贯
海蜇	海蛰
年轻人	年青人
影碟机	影牒机
孕育	蕴育
装订	装钉
纰漏	批漏
娇嗔	娇瞋
举例子	举列子
队列	队例
谩骂	曼骂 漫骂
休息	修息
坚定	竖定
反射弧	反射狐
剽窃	骠取 骠窃
肇事	造事
狼藉	狼籍
慰藉	慰籍 尉藉
黯然	暗然
奔驰	奔弛
荟萃	荟翠
堆砌	堆彻
澎湃	彭拜
血型	血形
退行性	退形性
账务	帐务
一笔一画	一笔一划
张贴	张帖
补贴	补帖
汛期	讯期
迅速	讯速 汛速
消费券	消费卷
应届	应界
界限	届限
抒发	纾发
巾帼	巾幅
辩证	辨证
辨别	辩别
辩论	辫论 辨论
廿八	甘八
广袤	广茅 广矛 广褒
堰塞湖	偃塞湖
鳙鱼	镛鱼 庸鱼
咳嗽	咳数
鲫鱼	即鱼
磋商	嗟商 蹉商
篆刻	纂刻
绳索	绳锁
公布	公步
雄踞	雄居
抓现行	抓现形
锈迹	秀迹
临界点	零界点
关键词	关建词 关健词
白内障	百内障
里程碑	里程牌
周大福	周大幅
簕杜鹃	勒杜鹃
研习社	演习社
工商界	工商届
文艺界	文艺届
艺术界	艺术届
综合征	综合症
攻坚战	攻艰战
全天候	全天侯
侦察兵	侦查兵
过敏原	过敏源
里脊	里背
拨打	拔打
赴京	附京
老赖	老懒
楼梯	楼剃
斡旋	握旋
须臾	须余
厮守	斯守
缱绻	缱卷
颀长	奇长
地痞	地否
溺爱	腻爱
端倪	端泥
懵懂	瞢懂
联袂	连袂 联决
倥偬	倥惚
傀儡	傀类
市侩	市刽
铿锵	铿镪
溘然	磕然
调侃	调砍
诡谲	诡橘
孑然	子然
耿直	梗直
戕害	枪害
逞强	呈强
跌宕	跌荡
耷拉	茸拉 答拉
啜泣	辍泣 缀泣
苦涩	苦色
要挟	要胁
腼腆	腼典 湎腆
干瘪	干憋
奚落	溪落
匿名	溺名
蹂躏	揉躏
荼毒	茶毒
忸怩	扭怩
劫难	截难
嚣张	消张
侥幸	狡幸
休憩	休栖
诡计	鬼计
樊篱	蕃篱
奇葩	奇耙
豁达	阔达
佯装	徉装
颁奖	搬奖
懒惰	懒堕
倩影	茜影
甄别	甑别
荏苒	荏冉 任苒
禁锢	禁固
枯槁	枯稿
痼疾	固疾
干涸	干锢
犒劳	铐劳
赊欠	奢欠
喟叹	㥜叹
缜密	慎密
嗔怪	慎怪
遒劲	逑劲
弹劾	弹核
隔阂	隔阖
纨绔	执绔 纨侉
邋遢	瘌遢 邋塌
咫尺	只尺
沉疴	沉苛
徘徊	俳徊
边陲	边垂
推荐	推存
疮痍	疮夷
奸佞	奸吝
内疚	内柩
饯别	栈别
抽噎	抽咽
渣滓	渣宰
鏖战	鳌战
彪炳	彪丙
誊写	眷写 誉写
谗言	谄言 馋言 搀言
赞扬	簪扬
几率	机率
身材	身才
习惯	刁惯
花瓣	花辩 花辦
悲哀	悲衰
诞生	延生
希望	烯望
糟蹋	糟塌 遭蹋
捯饬	倒饬
甘霖	泔霖
拐杖	捌仗
不满	不瞒
境界	竟界
凝视	疑视
塞车	赛车
你们	您们
涟漪	连漪
一瞬间	一舜间
蛀蚀	蛀食
会晤	会悟
熔炉	融炉
疯癫	疯颠
菜篮子	菜蓝子
掉头	调头
泼洒	泼撒
凸显	突显
累计	累积
激励	激厉
扑救	仆救
智慧	智惠
嬉戏	嘻戏
诡辩	鬼辩 诡辨
绝对	决对
身份证	身份政
亲和力	亲合力
竹竿	竹芋 竹杆
桂冠	贵冠
赌博	睹博 赌搏
副作用	付作用
综合症	中和症
谜团	迷团
果腹	裹腹
和谐	合谐 和偕
候车	侯车
磕巴	嗑巴
账簿	账薄
孤零零	孤伶伶
纪录片	记录片
检察院	检查院
屏气	摒气
粲然	灿然
岔路	叉路
穿戴	穿带
扳机	板机
厨房	橱房
砥砺	诋砺 砥励
怀揣	怀惴
谛听	啼听
迸发	并发
布置	部置
沧海	仓海
婵娟	蝉娟
掂量	惦量
怅然	伥然
仓猝	仓卒
摧毁	催毁
陡坡	陡徒 徒坡
胡话	糊话
垮台	跨台
寂寥	寂廖
慑服	摄服
鬼祟	鬼崇
惋惜	碗惜 婉惜
打鱼	咑鱼 打渔
欢度	欢渡
悱恻	绯恻
俯瞰	俯看
涣散	焕散
调剂	调济
粗粝	粗砺
菱形	棱形
粉末	粉沫
接洽	接恰
教唆	教梭
枉费	妄费
操作	操做
锻炼	段炼 缎炼
费力	废力
惊骇	惊赅
含混	含浑
既然	即然
黄连	黄莲
作揖	做揖
安分	安份
钓竿	钓杆
蒿子	篙子
惶惑	徨惑
狙击	狙击 沮击
高亢	高炕 高吭
盲目	肓目
暮色	幕色
困扰	困挠
闪烁	闪铄
搪塞	塘塞
游弋	游戈
具备	俱备
恪守	客守 格守
护栏	护拦
俘虏	俘掳 孚虏
报效	报孝
蜂拥	蜂踊
纷纭	纷云
活泛	活乏
姑息	估息
诚恳	诚垦 诚肯
熟练	熟炼
偌大	诺大
晌午	响午
提纲	题纲
发泄	发泻
昏庸	昏慵
贪赃	贪脏
俸禄	奉禄
晾干	凉干
糨糊	浆糊
蜕变	脱变
拆卸	拆御
急躁	急燥
恳求	肯求
是非	事非
雀跃	鹊跃
不屑	不宵
涌现	勇现 俑现 拥现
由衷	由哀
欣慰	心慰
怡情	贻情
遐想	暇想
大致	大至
狩猎	守猎
泯灭	抿灭
蓑衣	梭衣 衰衣
起码	起玛
侮辱	梅辱
湖畔	胡畔
报偿	抱偿
猖獗	昌獗
规矩	规距
港口	巷口
缥缈	缥渺
飘摇	飘遥
瞻仰	瞻养
惊愕	惊谔
时候	时侯
威胁	威协
协助	胁助
琐碎	锁碎
宵夜	霄夜
放肆	放肄
愚昧	愚味
羽翼	羽冀
胁迫	协迫 肋迫
栖息	牺息
厢型车	箱型车
延长	廷长
派遣	派谴
谴责	遣责
山坳	山拗
贪婪	贪焚
逍遥	消遥
熏陶	熏淘
烟囱	烟卤
赡养	瞻养
庄严	壮严
臆测	意测
札记	扎记
自持	自侍
从容	怂容
梳妆	梳装
元气	原气
跋涉	拔涉
逻辑	罗辑
布帛	布箔
敬佩	敬配
焕发	涣发
干预	干予
揣测	惴测
坦诚	坦城
按捺	安捺
包涵	包函
弊病	蔽病
编篡	偏篡
辨认	辩认
蹩进	憋进
博取	搏取
仓皇	怆皇
参与	参予
苍茫	沧茫
板脸	扳脸
褒贬	褒砭
辈分	辈份
泊位	舶位
残骸	残骇
偿还	尝还
撑杆	称杆
惆怅	惆帐 绸怅 稠怅
抵消	抵销
钓鱼	钩鱼
喋血	蝶血
杜绝	堵绝
繁琐	繁锁 烦锁
缀学	坠学
蹉跎	蹉驼 搓拓 搓跎 踌跎
怠惰	怠堕
颠倒	巅倒
临摹	临莫 林摹
纹身	文身
处身	处艮
苍生	苍升
称赞	秤赞
澄澈	橙澈
锄头	助头
传奇	穿奇
擦拭	擦式
蚩尤	赤尤
成功	成攻
诚实	成实
慈爱	慈噯
倘佯	倘样
促狭	促夹
充分	充纷
成熟	成孰
笞刑	笞刊
裁员	裁圆
次要	茨要
纯熟	莼熟
粲粲	梷梷
昌盛	菖盛
畜生	搐生
藏拙	藏出
脆弱	脆溺
刺身	朿身
池塘	池唐
出轨	处轨
出殡	出傧
淳淳	谆谆
粗鄙	粗俾
晨露	晨潞
船坞	船乌
嗤笑	蚩笑
崇尚	嵩尚
创新	怆新
篡改	纂改 篆改
尘嚣	尘器
痴迷	痴谜
粗鲁	粗橹
茶寮	茶燎
锤炼	锤练
矗立	矗位
出糗	出嗅
出道	出到
涔涔	岑岑
侧面	则面
孱弱	潺弱
嵯峨	槎峨
醇香	淳香
萃取	粹取
差役	差殁
弛缓	弛援
长啸	长萧
出炉	出妒
撮鸟	最鸟
陈情表	程情表
吃瘪	吃憋
祠禄	词禄
苍蝇	苍绳
齿胄	齿胃
乘月	乖月
衬托	衬乇
推测	蓷测
尘缘	尘橼
雏菊	刍菊
绸缪	绸谬
床笫	床第
吹捧	吹棒
酬酢	酬祚
抽泣	抽立
产业链	产业连
蝉衣	蝉伊
谄媚	陷媚 谄眉
春妍	春研
窗扉	窗霏
彩虹	彩红
猜忌	猜己
簇簇	族族
绰约	焯约
烦琐	烦锁
糟糕	遭糕
遭遇	糟遇
臆想	意想
亢奋	吭奋
键盘	健盘
贸易	冒易
丑陋	丑漏
芯片	蕊片
距离	矩离
领袖	领柚
潋滟	潋艳
琉璃	琉离
沥青	历青
蝼蚁	娄蚁
笼罩	拢罩
篱笆	篱芭 蓠笆
落魄	落魂
吝啬	吝墙
镰刀	廉刀
累赘	累坠
铭刻	名刻
密封	秘封
墨绿	默绿
谬论	缪论
马厩	马既
私塾	私孰
绥靖	妥靖
洒脱	酒脱
隧道	遂道
收敛	收俭
执拗	执幼
纳谏	纳柬
回馈	回遗 回贵
忽略	勿略
辉煌	辉隍
颔首	颌首
永恒	永垣
逶迤	逶移
蜿蜒	蜿延
婉转	蜿转
雾霾	雾埋
顽劣	玩劣
玩具	顽具
瘟疫	瘟役 温役 温疫
晚霞	晚暇
无耻	无址
婉约	宛约
微笑	徽笑
要塞	要赛
营销	营消
羡慕	羡幕
娴熟	闲熟
骁勇	枭勇
战栗	战粟
阻挠	阻桡
滋润	滋闰
锱铢	锱珠
造诣	造旨 造指
作祟	作崇
挚爱	掣爱
折戟	折乾
乾坤	戟坤
辎重	锱重 淄重
蒸馏	蒸留
板栗	板粟
圆寂	园寂
翡翠	翡粹
青衫	青杉
软肋	软协
壤土	土囊
蓬蒿	蓬高
匍匐	圃匐
朴素	仆素
彷徨	旁徨
滂沱	滂它
叵测	回测
偏颇	偏破
磅礴	磅薄 旁薄
培养	赔养 焙养 倍养
赔付	陪付
膀胱	徬胱
拔河	拨河
脾气	啤气
婀娜	婀那 啊娜
提拔	提拨
逃窜	逃串
练习簿	练习薄
吊销	吊消
豆腐	豆付
惰性	隋性
繁缛	繁溽
歼灭	千灭
怪诞	怪涎
关键	关健
光芒	光茫
瑰丽	鬼丽
捍卫	焊卫
浩瀚	浩翰
淮河	准河
嘉宾	佳宾
拂晓	佛晓
生效	生校
歌舞	歌午
鼓噪	鼓燥
冠冕	冠免
鬼蜮	鬼域
海绵	海棉
简陋	简漏
贸然	冒然
拇指	母指
苦恼	苦脑
脉络	脉胳
骚动	搔动
唏嘘	稀嘘
揶揄	掖揄
徜徉	徜佯
恣睢	姿睢
睿智	锐智
多元化	多元画
妒忌	炉忌
堕入	惰入
东瀛	东赢
等比数列	等比数例
道德	道聴
丁香结	丁香洁
得过且过	的过且过
怠慢	怠漫 殆慢 待慢
嘟嘟囔囔	都都囔囔
端庄	瑞庄
鼎力	鼑力
迭代	跌代
地动仪	地动义
弟媳	弟息
奠基	尊基
大锣	大罗
惰性气体	隋性气体
独舞	独儛
叮咛	叮宁
等闲	等咸
地球村	地求村
敦敏	墩敏
端端正正	端端佂佂
打量	打亮
抖擞	斗擞
耽误	眈误
大幅度	大副度
阔绰	阔踔 阔琸 阔桌 阔悼
杜门自守	社门自守
节省	栉省
胆大妄为	胆大忘为
大伙儿	大火儿
倒计时	到计时
动词	动祠
担当	掸当
颠簸	颠钹
陡峭	徙峭
胆战心惊	胆站心惊
大师	大帅
大规模	大规膜
惦念	掂念
迭起	迭齐
叨叨	刀刀
多功能	多工能
瞪瞪	登登
悼念	悼惗
缔结	帝结
蹀躞	蝶躞
地狱	哋狱
多彩	多采
荡漾	荡様
雕琢	雕诼 雕逐
督促	督处
点映	点央
地道	地到
督察	督嚓
顶呱呱	顶瓜瓜
带来	戴来
渎职	读职
杜衡	渡衡 杜蘅
佃农	田农 钿农
鼎盛	顶盛 鼎晟
铣刀	洗刀
镀金	度金
笃行	茑行
奠定	莫定
饾饤	豆丁
孕妇	任妇
敦促	墩促
玷污	坫污 沾污
殆尽	台尽
断肠	断常
镀锌板	镀辛板
踱步	镀步 度步
党徽	党微
凋谢	调谢
豆荚	豆夹
淡薄	淡簿 淡礴
滇池	慎池
鞑靼	鞑但
担心	但心
但是	旦是
祷告	祷诰
嚼碎	爵碎
打烊	打羊
吊唁	吊言
巅峰	颠峰 巅锋
兑付	兑负
带领	戴领
电阻	电狙
刁难	习难
点卯	点卵
笃信	茑信 独信
砥柱	抵柱
斗志	抖志
地窖	地滘
晴天	睛天
渡江	度江
搭档	搭挡
定夺	订夺
丹凤眼	丹风眼
底蕴	底蕰
风筝	风争
返乡	反乡
放纵	放从
会见	汇见
分外	份外
菲薄	绯薄
沸腾	佛腾 沸滕 拂腾
服从	服丛
附议	附仪
贩卖	饭卖
伏法	服法
俯首	俯守
富饶	富绕
废黜	废絀
愤慨	愤概
繁殖	繁植
烦恼	烦脑
房檐	房詹
枫叶	风叶
氛围	纷围 汾围
福利	福力
阀门	伐门
付与	付于
富裕	富峪
附件	付件
驸马	附马
缝隙	逢隙
冗余	冗于
福荫	福阴
讣告	仆告
服帖	服贴
贡献	供献
穿插	串插
默契	默挈
文牍	文渎
掠夺	略夺
赏罚	常罚
简练	蔺练 简炼
篡夺	纂夺
武装	武裝
演绎	演译
融会	融汇
荤腥	晕腥
强悍	强焊
皎洁	佼洁
手腕	手宛
整饬	整伤
证券	证卷
亟待	急待
狂妄	狂忘
伶俐	玲俐
连襟	联襟
云霄	云宵
拖沓	拖踏
隔膜	膈膜
良莠	良秀
告罄	告馨
袒护	坦护
胁从	协从
卫戍	卫戌
昭雪	招雪
沦落	伦落
沮丧	诅丧
魅力	魁力
檄文	激文
鹤唳	鹤戾
蜕化	脱化
荒谬	谎谬
撒谎	撒慌
谙熟	暗熟
共勉	共免
膈应	隔应
恭听	恭昕
根植	根值
聒噪	聒燥 呱噪 剐噪
辜负	辜付
躬行	射行
媾和	姌和
刽子手	脍子手 会子手
国祚	国作
勾当	沟当
歌咏	歌泳
贵庚	贵赓
过磅	过镑
柑橘	甘橘
砧板	沾板
沟壑	沟涸
工匠	功匠
归拢	归龙
功效	攻效
贵宾	贵兵
静谧	静宓 静密
阶乘	介乘
介意	阶意
荆棘	荆刺
拮据	拮剧
可汗	可汉
卓越	桌越
细菌	细箘
潇湘	潇相
悬殊	悬珠
锡箔	易箔
信誉	信誊
玄机	炫机
荣膺	荣鹰
箬笠	若笠
教授	教受
觊觎	觊愉
疾驰	疾弛
竞标	竟标
恐怖	恐布
理睬	理彩
琳琅	林琅
雷霆	雷廷
轮廓	轮郭
磨练	摩练
募集	暮集
魅惑	魅或
蜜饯	蜜贱
媲美	毗美 辟美
屏障	屏帐
拍摄	拍慑
陪衬	陪村
抛锚	抛猫
碰壁	碰璧
澄清	澄青
轻盈	轻楹
谦逊	谦孙
倾覆	倾复
泅渡	囚渡
蠕动	儒动
呼啸	胡啸
泓浵	弘彤
好歹	好殆
花苞	花包
红莲	红连
蛤蟆	哈蟆
翰林	瀚林
厚道	候道
华罗庚	华罗更
行当	行档
后盾	后遁
核发	核發
寒门	韩门
恍然	晃然
厚德	厚得
阖家	合家
麾下	摩下
窈窕	苗窕
湖泊	湖珀
红烛	红蚀
贿赂	贿路 汇赂
恢弘	恢宏
混沌	浑沌 混顿
惶恐	湟恐
慧然	惠然
怀瑾	怀谨
轰隆隆	轰窿窿
薨逝	薨势
夙愿	素愿
赇灾	振灾
讹诈	恶诈
别墅	别树
窒息	桎息
赦免	赫免
阴霾	阴狸
羞赧	羞婪
惬意	箧意
馈赠	溃赠
缄默	减默
污秽	污晦
吞噬	吞筮
覆没	复没
攸关	优关
精湛	精堪
委靡	委糜
痊愈	全愈
贫瘠	贫脊
暮霭	暮蔼
严厉	严历
清晰	清淅
就绪	就序
耽搁	担搁
番茄	蕃茄
猕猴	弥猴
洗漱	洗嗽
嗓门	噪门
拨冗	拔冗
剐蹭	刮蹭
未遂	末遂
强奸	强奷
铆足	卯足
揭秘	揭密
冬菇	冬姑
香菇	香姑
草菇	草姑
纂缉	篡缉
纂编	篡编
纂修	篡修
篡位	纂位
欠账	欠帐
珍馐	珍羞
答卷	答券
开辟	开僻
短板	短版
业界	业届
纽扣	钮扣
纠纷	纠份
核拨	核拔
先驱	先躯
贴近	贴进
1亩	1苗
打拼	打拚
玍古	嘎咕
瘆人	渗人
熏肉	薰肉
炖菜	炖莱
同胞	同袍 同孢
蓓蕾	培蕾
投奔	头奔
包庇	包痹
麻痹	麻庇
摒弃	屏弃
菠菜	波菜
粗糙	粗造
嘈杂	炒杂
刹那	杀那
赔偿	陪偿
奢侈	奢耻
踌躇	蹉躇
拙见	绌见
忌惮	忌掸
档案	挡案
追悼	追绰
提防	堤防
缔造	蒂造
兑换	兌换
阿谀	阿腴
扼要	伌要
沸点	渄点
仿佛	纺佛
果脯	果甫
供销	供消
口供	口共
粗暴	粗爆
皈依	归依
负荷	负何
混淆	混肴
汽水	气水
留恋	流恋
需要	须要
很是	很实
刻不容缓	刻不容援
横七竖八	横七树八
迥乎不同	炯乎不同
山肴野蔌	山肴野簌
泛滥成灾	泛烂成灾
抱打不平	报打不平
毫不介意	豪不介意
鄙夷不屑	鄙夷不肖
穷形尽相	穷形尽像
垂青	倕青
一败涂地	一败途地
滕州	腾州 藤州
腾飞	藤飞 滕飞
树藤	树腾 树滕
抑郁	柳郁 仰郁
仰首	柳首 抑首
杨柳	杨仰 杨抑
干燥	干澡 干躁
拂袖	佛袖 沸袖
佛门	拂门 沸门
嘶哑	斯哑 撕哑
撕毁	嘶毁 斯毁
如斯	如撕 如嘶
湍急	揣急 瑞急
祥瑞	祥揣 祥湍
照样	煦样 熙样
康熙	康照 康煦
酒酿	酒狼 酒浪
波浪	波狼 波酿
饿狼	饿浪 饿酿
熟悉	孰悉
不熟	不孰
孰不可忍	熟不可忍
驮马	驭马 驱马
驱动	驮动 驭动
勇敢	涌敢 俑敢
兵马俑	兵马勇 兵马涌
坑蒙拐骗	吭蒙拐骗 炕蒙拐骗
吭声	坑声 炕声
火炕	火吭 火坑
拟定	似定 以定
似乎	拟乎 以乎
以为	似为 拟为
嫂嫂	馊馊 嗖嗖
馊主意	嫂主意 嗖主意
嗖一声	嫂一声 馊一声
棚子	崩子 蹦子
蹦跳	棚跳 崩跳
崩塌	蹦塌 棚塌
撩人	缭人 暸人
了望	了望
缭绕	暸绕 撩绕
嘹亮	潦亮 僚亮
官僚	官潦 官嘹
潦倒	僚倒 嘹倒
烙印	路印 洛印
洛阳	路阳 烙阳
路过	烙过 洛过
掩盖	淹盖 俺盖
俺们	掩们 淹们
纺织	仿织 访织
效仿	效纺 效访
访问	纺问 仿问
鸟喙	鸟缘 鸟篆
篆书	喙书 缘书
框子	眶子 筐子
箩筐	箩框 箩眶
眼眶	眼筐 眼框
潮汛	潮迅 潮讯
简讯	简迅 简汛
烘焙	烘培 烘倍
倍数	培数 焙数
缎子	段子 锻子
段落	缎落 锻落
指示	绢示
手绢	手指
一幢	一憧
炽热	织热
织布	炽布
帖子	贴子
舔舐	添舐
添乱	舔乱
波澜	波斓 波澜
眷恋	卷恋
试卷	试券 试眷
棉袄	棉沃
肥沃	肥袄
山峦	山恋
恋人	峦人
讯息	汛息
票券	票卷
行驶	行驭
请帖	请贴
拖拉	施拉
施肥	拖肥
鱼钩	鱼钓
腐化堕落	腐化坠落
陨石坠落	陨石堕落
暗度陈仓	暗渡陈仓
花样迭出	花样叠出
蜚短流长	斐短流长
冬夏常青	冬夏长青
倍道而行	背道而行
白云苍狗	白云沧狗
作壁上观	作璧上观
薪火相承	薪火相成
马到成功	马到程功
能源匮缺	能源篑缺
触景生情	触境生情
大江截流	大江节流
娇生惯养	矫生惯养
李代桃僵	李代桃缰
名缰利锁	名僵利锁
明枪暗箭	明枪暗剑
亟待解决	急待解决
急需处理	亟需处理
拾人牙慧	拾人牙惠
平等互惠	平等互慧
马革裹尸	马革果尸
合家欢乐	和家欢乐
引吭高歌	引亢高歌
粉身碎骨	粉身碎股
事必躬亲	事必恭亲
山重水复	山重水覆
胜券在握	胜券在握 胜卷在握
开卷有益	开券有益 开卷有益
能屈能伸	能曲能伸
青山绿水	清山绿水
凭恃天险	平恃天险
偷梁换柱	偷粱换柱
妙语连珠	妙语联珠
沧海一粟	沧海一栗
三足鼎立	三足鼎力
身体力行	身体厉行
入情入理	入情入里
烂尾工程	滥尾工程
形迹可疑	行迹可疑
行迹无定	形迹无定
发人深省	发人深醒
如梦初醒	如梦初省
华丽炫目	华丽眩目
闻过则喜	文过则喜
烟消云散	烟销云散
波浪滔天	波浪涛天
老马识途	老马识图
大事渲染	大肆渲染
大肆挥霍	大事挥霍
誓死不渝	势死不渝
势在必行	誓在必行
以身试法	以身拭法
拭目以待	试目以待
额手相庆	额首相庆
疾首蹙额	疾手蹙额
临渊羡鱼	临渊羡渔
拈轻怕重	沾轻怕重
头昏脑涨	头昏脑胀
神情忧郁	神情优郁
桃园结义	桃源结义
立意新颖	立异新颖
唇齿相依	唇齿相倚
遗臭万年	贻臭万年
相映成趣	相印成趣
风起云涌	风起云拥
